ACTIVATE	AE K T AH V EY T
AUTOPILOT	AO T OW P AY L AH T
COMMAND	K AH M AE N D
EIGHT	EY T
FIVE	F AY V
FOUR	F AO R
NINE	N AY N
OH	OW
ONE	W AH N
ONE(2)	HH W AH N
RETIRE	R IH T AY R
RETIRE(2)	R IY T AY R
RETIRE(3)	R IY T AY ER
SEARCH	S ER CH
SEVEN	S EH V AH N
SHUTDOWN	SH AH T D AW N
SIX	S IH K S
THREE	TH R IY
TOGGLE	T AA G AH L
TWO	T UW
